#Aooooooo#       #       #       #########          #               #          #
#####o  o#####   ### ##### ##### ######### ######## ##### ######### #########  #
#oooooooo #      #       #           #               #               #         #
#o######o## #### ####### ########### ################# ############# #######   #
#oooooooo #      #       #                 #          #          #         #   #
# ######o## ########### ########### ###### # ########## ####### ########## #####
#    oooo #          #           # #       #               #            #      #
#####o########### ##### ########## ########### ########## ##### ######## ##### #
#    ooooooooooo#      #      #        #            #          #        #      #
###############o######## ##### ########### ######## ###### ############# ##### #
#oooooooooooooooooooo#      #       #         #            #               #   #
#o######o###########o########## ######## ############################## #### ###
#o   #  ooooooooooooo#             #       #              #                #   #
#o#######o############ ####################### ########### ####### ########### #
#ooooooooooo#          #                     #         #   #                   #
# #########o########## ############################## ##### ################# ##
#         #ooo         #                  #          #         #               #
# ###### ####o########### ####### ########### ####### #### ########### #########
#       #ooooo          #     #    #        #             #    #        #      #
######## o#################### #### ######### ########### ##### ######## #######
#        ooooooo             #      #              #      #     #              #
###############o###########################   ##################################
#       #######o########## ##### ########## ########### ######### ##############
#       #      oo         #              #    #      #      #             #    #
##### ##########o######### ########## ###### ##### ######## ###### ##### ##### #
#  ooo#         ooooooo#    #        #    #     #       #        #     #       #
###o#o################o######## ###### ######## ####### ######### ##### ########
#ooo#oooooooooooooooooo      #      # #            #          #         #      #
#o########## #####o################# ### ############ ######## ######## ########
#o     #         #ooooo              #       #              # #                #
#o########## #########o#################### ##### ########### ######### ########
#oooooooo#     # oooooo #             #        # #            #         #      #
# ######o########o####### ########### ########## ########## #### ####### #######
#    #  oooooooooooo  #              #                      #        #         #
###################o########################### ########         ###############
#    oooooooooo#oooo                                #                          #
#    o  o#ooooooo#       #       #########          #               #          #
#####oooo#####   ### ##### ##### ######### ######## ##### ######### #########  #
#       o #      #       #           #               #               #         #
# ######o## #### ####### ########### ################# ############# #######   #
#oooooooo #      #       #                 #          #          #         #   #
#o######o## ########### ########### ###### # ########## ####### ########## #####
#oooooooo #          #           # #       #               #            #      #
#####o########### ##### ########## ########### ########## ##### ######## ##### #
#    ooooooooooo#      #      #        #            #          #        #      #
###############o######## ##### ########### ######## ###### ############# ##### #
#oooooooooooooooooooo#      #       #         #            #               #   #
#o######o###########o########## ######## ############################## #### ###
#o   #  ooooooooooooo#             #       #              #                #   #
#o#######o############ ####################### ########### ####### ########### #
#ooooooooooo#          #                     #         #   #                   #
# #########o########## ############################## ##### ################# ##
#         #ooo         #                  #          #         #               #
# ###### ####o########### ####### ########### ####### #### ########### #########
#       #ooooo          #     #    #        #             #    #        #      #
######## o#################### #### ######### ########### ##### ######## #######
#        ooooooo             #      #              #      #     #              #
###############o###########################   ##################################
#       #######o########## ##### ########## ########### ######### ##############
#       #      oo         #              #    #      #      #             #    #
##### ##########o######### ########## ###### ##### ######## ###### ##### ##### #
#  ooo#         ooooooo#    #        #    #     #       #        #     #       #
###o#o################o######## ###### ######## ####### ######### ##### ########
#ooo#oooooooooooooooooo      #      # #            #          #         #      #
#o########## #####o################# ### ############ ######## ######## ########
#o     #         #ooooo              #       #              # #                #
#o########## #########o#################### ##### ########### ######### ########
#oooooooo#     # oooooo #             #        # #            #         #      #
# ######o########o####### ########### ########## ########## #### ####### #######
#    #  oooooooooooo  #              #                      #        #         #
###################o########################### ########         ###############
#    oooooooooo#oooo                                #                          #
#    o  o#ooooooo#       #       #########          #               #          #
#####oooo#####   ### ##### ##### ######### ######## ##### ######### #########  #
#       o #      #       #           #               #               #         #
# ######o## #### ####### ########### ################# ############# #######   #
#oooooooo #      #       #                 #          #          #         #   #
#o######o## ########### ########### ###### # ########## ####### ########## #####
#oooooooo #          #           # #       #               #            #      #
#####o########### ##### ########## ########### ########## ##### ######## ##### #
#    ooooooooooo#      #      #        #            #          #        #      #
###############o######## ##### ########### ######## ###### ############# ##### #
#oooooooooooooooooooo#      #       #         #            #               #   #
#o######o###########o########## ######## ############################## #### ###
#o   #  ooooooooooooo#             #       #              #                #   #
#o#######o############ ####################### ########### ####### ########### #
#ooooooooooo#          #                     #         #   #                   #
# #########o########## ############################## ##### ################# ##
#         #ooo         #                  #          #         #               #
# ###### ####o########### ####### ########### ####### #### ########### #########
#       #ooooo          #     #    #        #             #    #        #      #
######## o#################### #### ######### ########### ##### ######## #######
#        ooooooo             #      #              #      #     #              #
###############o###########################   ##################################
#       #######o########## ##### ########## ########### ######### ##############
#       #      oo         #              #    #      #      #             #    #
##### ##########o######### ########## ###### ##### ######## ###### ##### ##### #
#  ooo#         ooooooo#    #        #    #     #       #        #     #       #
###o#o################o######## ###### ######## ####### ######### ##### ########
#ooo#oooooooooooooooooo      #      # #            #          #         #      #
#o########## #####o################# ### ############ ######## ######## ########
#o     #         #ooooo              #       #              # #                #
#o########## #########o#################### ##### ########### ######### ########
#oooooooo#     # oooooo #             #        # #            #         #      #
# ######o########o####### ########### ########## ########## #### ####### #######
#    #  oooooooooooo  #              #         ooooooooooooo#        #         #
###################o###########################o########o  oooooo###############
#              #   ooooooooooooooooooooooooooooo    #   ooooooooooooooooooooooB#
