#A       #       #       #       #########          #               #          #
#####    #####   ### ##### ##### ######### ######## ##### ######### #########  #
#         #      #       #           #               #               #         #
# ###### ## #### ####### ########### ################# ############# #######   #
#         #      #       #                 #          #          #         #   #
# ###### ## ########### ########### ###### # ########## ####### ########## #####
#         #          #           # #       #               #            #      #
##### ########### ##### ########## ########### ########## ##### ######## ##### #
#               #      #      #        #            #          #        #      #
############### ######## ##### ########### ######## ###### ############# ##### #
#                    #      #       #         #            #               #   #
# ###### ########### ########## ######## ############################## #### ###
#    #               #             #       #              #                #   #
# ####### ############ ####################### ########### ####### ########### #
#           #          #                     #         #   #                   #
# ######### ########## ############################## ##### ################# ##
#         #            #                  #          #         #               #
# ###### #### ########### ####### ########### ####### #### ########### #########
#       #               #     #    #        #             #    #        #      #
########  #################### #### ######### ########### ##### ######## #######
#                            #      #              #      #     #              #
############### ###########################   ##################################
#       ####### ########## ##### ########## ########### ######### ##############
#       #                 #              #    #      #      #             #    #
##### ########## ######### ########## ###### ##### ######## ###### ##### ##### #
#     #                #    #        #    #     #       #        #     #       #
### # ################ ######## ###### ######## ####### ######### ##### ########
#   #                        #      # #            #          #         #      #
# ########## ##### ################# ### ############ ######## ######## ########
#      #         #                   #       #              # #                #
# ########## ######### #################### ##### ########### ######### ########
#        #     #        #             #        # #            #         #      #
# ###### ######## ####### ########### ########## ########## #### ####### #######
#    #                #              #                      #        #         #
################### ########################### ########         ###############
#              #                                    #                         B#
